Toy Story => Animation Comedy Family 5
Jumanji =>  Adventure Fantasy Family 3
Grumpier Old Men => Romance Comedy 2
Waiting to Exhale => Comedy Drama Romance 1 
Father of the Bride Part II => Comedy 3
Heat => Action Crime Drama Thriller 1
Sabrina => Comedy Romance 1
Tom and Huck => Action Adventure Drama Family 1 
Sudden Death => Action Adventure Thriller 2
GoldenEye =>  Adventure Action Thriller 3
The American President => Comedy Drama Romance 4  
Dracula: Dead and Loving It => Comedy Horror 5
Balto =>  Family Animation Adventure 2
Nixon => History Drama 3
Cutthroat Island => Action Adventure 4  
Casino => Drama Crime 5
Sense and Sensibility => Drama Romance 3  
Four Rooms => Crime Comedy 4
Ace Ventura: When Nature Calls => Crime Comedy Adventure 5 
Money Train => Action Comedy Crime 4
Get Shorty => Comedy Thriller Crime 5 
Copycat => Drama Thriller 5
Assassins => Action Adventure Crime Thriller 2 
Powder => Drama Fantasy Science Fiction Thriller 1  
Leaving Las Vegas => Drama Romance 3
Othello => Drama 2
Now and Then => Comedy Drama Family 3 
Persuasion => Drama Romance 4
The City of Lost Children => Fantasy Science Fiction Adventure 5  
Shanghai Triad => Drama Crime 2
Dangerous Minds => Drama Crime 3 
Twelve Monkeys => Science Fiction Thriller Mystery 1 
Wings of Courage => Romance Adventure 5
Babe => Fantasy Drama Comedy Family 4
Carrington => History Drama Romance 2
Dead Man Walking => Drama 1
Across the Sea of Time =>  Adventure History Drama Family 5 
It Takes Two => Comedy Family Romance 3
Clueless => Comedy Drama Romance 2
Cry, the Beloved Country => Drama 5 
Richard III => Drama War 2
Dead Presidents => Action Crime Drama History 3  
Restoration => Drama Romance 4
Mortal Kombat => Action Fantasy 4  
To Die For => Fantasy Drama Comedy Thriller 4  
How To Make An American Quilt => Drama Romance 2  
Seen => Crime Mystery Thriller 1
Pocahontas =>  Adventure Animation Drama Family 5  
When Night Is Falling => Drama Romance 2
The Usual Suspects => Drama Crime Thriller 3 
Guardian Angel => Action Thriller Drama 4
Mighty Aphrodite => Comedy Romance 5
Lamerica => Drama Foreign 2
The Big Green => Action Adventure Comedy Family 1 
Georgia => Drama 3
Home for the Holidays => Comedy Drama Romance 4  
The Postman => Comedy Drama Romance 2
The Confessional => Thriller Drama Mystery 1  
The Indian in the Cupboard =>  Adventure Family Fantasy 3  
Eye for an Eye => Drama Thriller 4
Mr. Holland s Opus => Music Drama Family 5  
Don t Be a Menace to South Central While Drinking Your Juice in the Hood => Comedy 2
Two If by Sea => Comedy Romance 3
Bio-Dome => Comedy 3  
Lawnmower Man : Beyond Cyberspace => Action Science Fiction 4  
Two Bits => Drama Family 2
French Twist => Comedy Romance 1  
Friday => Comedy 5
From Dusk Till Dawn => Horror Action Thriller Crime 4  
Fair Game => Action Thriller Romance 3
Kicking and Screaming => Comedy Drama Romance 2  
Les Miserables => Drama History 1
Bed of Roses => Drama Romance 4
Big Bully => Comedy Family 5
Screamers => Horror Science Fiction 1  
Nico Icon => Documentary 2
The Crossing Guard => Drama Thriller 3  
The Juror => Drama Thriller 4
The White Balloon =>  Family Drama 5  
Things to Do in Denver When You re Dead => Drama Crime 2  
Antonia s Line => Drama Comedy 3
Once Upon a Time... When We Were Colored => Romance Drama 1  
Angels and Insects => Drama Romance 5  
White Squall => Action Drama 4  
Dunston Checks In =>  Adventure Comedy Family 3 
Black Sheep => Comedy 2
Nick of Time => Crime Drama Thriller 1  
The Journey of August King => Drama 2
Mary Reilly => Drama Horror Thriller Romance 3  
Vampire in Brooklyn => Comedy Horror Romance 4
Beautiful Girls => Comedy Drama Romance 5
Broken Arrow => Action Adventure Drama Thriller 1  
A Midwinter s Tale => Comedy 2
La Haine => Drama 3
Shopping => Action Adventure Drama Science Fiction Thriller 4
Heidi Fleiss: Hollywood Madam => Documentary 5
City Hall => Drama Thriller 4
Bottle Rocket => Comedy Crime Drama 3  
Mr. Wrong => Comedy Romance 2
Unforgettable => Drama Mystery Science Fiction Thriller 1 
Happy Gilmore => Comedy 4
The Bridges of Madison County => Drama Romance 1  
Nobody Loves Me => Drama Comedy Family 2
Muppet Treasure Island => Action Comedy Music Family Adventure 3  
Catwalk => Documentary 4
Headless Body in Topless Bar => Crime 5  
Braveheart => Action Drama History War 5 
Taxi Driver => Crime Drama 2
Rumble in the Bronx => Crime Action Comedy Thriller 3  
Before and After => Drama Thriller 4
Margaret s Museum => Drama 5
Happiness Is in the Field => Comedy 2  
Anne Frank Remembered => Documentary Drama Foreign 1  
The Young Poisoner s Handbook => Comedy Crime Drama 2 
If Lucy Fell => Comedy Romance 4
Steal Big Steal Little => Comedy Drama 5  
Race the Sun => Action Adventure Comedy Drama Family 2 
The Boys of St. Vincent => Drama 1
Boomerang => Comedy Romance 2
Chungking Express => Drama Comedy Romance 2  
The Star Maker => Drama Romance 1
Flirting with Disaster => Comedy Romance 2  
The Neverending Story III: Escape from Fantasia => Fantasy 3  
The Silences of the Palace => Drama 4
Pie in the Sky => Comedy Romance 5
Angela => Comedy Drama 2
Frankie Starlight => Drama Romance War 1  
Jade => Action Thriller Mystery Romance 3 
Nueba Yol => Comedy Drama Romance 2
Sonic Outlaws => Music Documentary 1 
Down Periscope => Comedy 3
From the Journals of Jean Seberg => Documentary 5 
Man of the Year => Comedy 3
The Neon Bible => Drama 2
Target => [] 2
Up Close & Personal => Drama Romance 1  
The Birdcage => Comedy 3
Virgin Mary => Drama 4
The Brothers McMullen => Comedy Drama Romance 3  
Bad Boys => Action Comedy Crime Thriller 5
The Amazing Panda Adventure => Action Adventure Drama Family 5  
The Basketball Diaries => Drama Crime 5
An Awfully Big Adventure => Romance Drama Comedy 4  
Amateur => Crime Comedy Drama Thriller 4
Apollo  => Drama 4
Rob Roy =>  Adventure 4  
The Addiction => Drama Horror 3  
Batman Forever => Action Crime Fantasy 3  
Belle de Jour => Drama Romance 3
Beyond Rangoon => Drama Thriller 2  
Blue in the Face => Comedy 2
Canadian Bacon => Action Comedy 2 
Casper => Fantasy Comedy Family 2
Clockers => Mystery Crime Drama 1
Congo => Action Adventure Drama Mystery Science Fiction Thriller 1  
Crimson Tide => Action Thriller Drama 1
Crumb => Documentary 4
Desperado => Thriller Action Crime 3  
Devil in a Blue Dress => Drama Mystery Thriller 5  
Die Hard: With a Vengeance => Action Thriller 2
The Doom Generation => Action Comedy Crime Drama 1 
Feast of July => Drama Crime 5
First Knight => Action Adventure Drama Romance 1  
Free Willy  - The Adventure Home =>  Adventure 4
Hackers => Action Crime Thriller Drama 2
Jeffrey => Comedy Drama Romance 3
Johnny Mnemonic =>  Adventure Action Drama Science Fiction Thriller 1  
Judge Dredd => Science Fiction 5
Jury Duty => Comedy Drama 2
Kids => Drama Crime 4
Living in Oblivion => Drama Comedy 3 
Lord of Illusions => Mystery Horror Thriller 3  
Love & Human Remains => Comedy Drama 4
Mad Love => Drama Family Romance 2
Mallrats => Romance Comedy 5
Mighty Morphin Power Rangers: The Movie => Action Adventure Science Fiction Family Fantasy 1
Moonlight and Valentino => Comedy Drama Romance 3
Mute Witness => Thriller Foreign 2
Nadja => Horror Thriller 4
The Net => Crime Drama Mystery Thriller Action 1  
Nine Months => Comedy 5
Party Girl => Comedy 3
The Prophecy => Fantasy Horror Thriller 3
Reckless => Fantasy Comedy Drama 2
Safe => Drama 1
The Scarlet Letter => Drama History Romance 5  
The Show => Documentary 2
Showgirls => Drama 3